MeiAs north=AGjsG south=CTUGC
GlNWq north=aEFxF south=DekKT west=fMFPD
wwyAT north=cvtCH west=SrTsN
wJzRx north=iUurS east=tZtfU south=sSjAD
aSNGu north=EffSO south=CqivM west=khQiL
VlJtf west=FSRtT
hHPqA east=GIaKA west=UAcjx
XzvdN south=BRgRG
AgJLW north=DrSBi south=MCjNj
RNNhX east=Jtspl south=TdBGH
ZotWI east=VNTpO west=vUoeK
nnPIr east=STOer south=icJPY
mcSNj east=ardkR west=PLfNp
HYzgU north=rdEYG south=cgSKW west=lsPeA
bVvDb north=EoYUQ east=ZPYOK
epdhg north=Vhpne east=AgpTF
nmQcl north=oVTBr
yBQbJ south=ROKEU
DDjqo east=bRnRC south=DfHBs
pQWlw north=XMUpZ east=uoPrX south=bIbxi
JzFLN south=SneLi west=qMFoC
YXvZC north=NfARt south=PEIVR west=BItUm
GgCNk south=FgrUU
DMVeh south=sqhwR west=oaQRb
DmnLp east=VYhMV west=ZVhZN
ijABn north=cgSKW south=tlPOi
XoYzO north=dbmxC east=vlInz south=dbmxC west=cBgzN
XpXEP east=fenMG south=gzTol
gMoTJ north=YINrV south=jYKsS
RxfyI east=wmatt south=VyGRZ west=DlrBG
Rnhzs east=OEeHJ west=YMATW
JpiMX east=UZoss south=bGCrQ
LkTXP north=ekFTn south=QUXMj
gzowr north=cVuOR south=qZyiG
gXONv north=cgSKW east=xmhRj south=dVksl west=iHJcN
zpFAR east=isDfZ west=edabS
tYCJP south=PaVmY
pMkZN north=FUksB south=zRgDJ west=GreuM
WBGLL south=ADijx west=GmQIj
ixDNI south=RByhz west=byEuP
pYgRs south=SZXji
pYmRF east=CQmyV west=PCkMu
rkFeW east=zpFAR
oqogC east=bzIry south=SneLi west=wmatt
uzblh north=YztCX east=qnedj south=dxtIm west=GBWUE
INoGW east=ckDrj south=VlJtf west=QfFzp
kUGqn north=AorRY east=EZSSR west=AgpTF
jeBPe north=DekKT east=IIvCc west=VYhMV
ABvAa north=DMBiX west=BaKOf
EUlUV north=lXwZu east=eeVor
Iokje south=CMUnr west=GlNWq
CFFOD east=bSUwr south=BedtS west=CMWZr
drfxa north=Axjxl south=oVdOC
ZxwOo north=DlrBG
ZLHSe east=IrOrK
TamwN east=ATKIC
MTlxS east=HWLwC south=qckjq
NOrXp south=CKpHB west=mryLW
adUPr north=SRsyv
gGFVu east=TRKzD south=LBbdQ
FbjUl south=nIvQG
ylkNa east=bcjOX west=KbeYZ
SRsyv south=yjjse
UyCrF east=nSYUy west=rYpmB
ziVDd south=SdhyI west=pwFEf
ZIRQk north=NhREk east=Saiif south=mryLW
hgBec north=asrNf south=TJSZx
GBcqf north=HNWph south=lZkBi west=eVJlD
YcGVk east=iVzJq
HmTej north=nnsEe west=ZotWI
cvtCH east=ardkR west=PGSDJ
BODTr east=dAXVh south=RprGa
GlzTX north=IUasE east=LAaWn west=epdhg
DRwOi north=MSTOj
aoCCx
EjgFp north=Vhpne east=dvsbI south=amXiN
YCXnF east=CQmyV
AjWDe north=ZzNKx west=DMBiX
YBFrn south=TxkDE west=PmiBo
nsBrN north=rdEYG east=cHays south=MQfzl west=BYxCy
qfyFg north=iVzJq south=sCnpz west=NBZkb
kgIJh north=QDpZB east=wmatt south=HYzgU
zjqBU north=sOAOP south=yewmZ west=NqVUf
vBKfn north=bzIry east=fYmSs west=QELmi
bDqzz north=NUbWz
NMwfW north=AyJxP south=cGmnK west=poKzN
Skjdl
rqjSq east=KHDqg south=KsnVF west=fDyPx
izgTT north=nvLfT
hVzcM north=tZtfU south=VPGof west=yBQbJ
wfVGd north=AmasX east=gympX south=qTsfB
HyHJE south=qoHxb west=pdmqO
jRbZT east=cEdio west=tZtfU
ZqReg west=pYmRF
yGpxU south=WILmV west=WugrH
btXrx north=hwEIo east=UAcjx
CvvWE south=TRMql west=eVqiL
vndqL west=qCoPF
OwTVO north=hqVtm east=ZnJsv south=yjjse west=IUasE
thobP north=VYmWn
kOvtF
Vhpne west=YbjUu
cEdio south=AOCak west=qzdCR
dxtIm north=IbCbf east=NSMBk west=pvFrC
poKzN south=FSjag west=WMqKA
jsKoy east=VYhMV south=ZWIHB
SNKAh south=XborS west=Aycye
BKbQg east=ajZct south=tQAJb west=aEFxF
XKhWS
bDiYM south=cKcCY
fPrzK east=sqhwR south=uDhCx west=YXvZC
WxGtq west=wmatt
jTqYE north=eZvoh east=etoON west=PNbnd
PFKrA west=sdTTZ
mqZvD north=saSYk east=UAcjx south=cOmmx west=hBmwX
zwRaU west=IrOrK
FksPi north=attTv east=nolty
YWtkj west=ZotWI
sIsVQ north=OuWhO east=iHJcN south=Dfzdh west=jutwz
IToZW north=SXjZx east=ZklOO
EyfRN east=tibrO south=FSjag
PXqnK
CkLLQ west=FSRtT
fNjdL north=AgaAX south=rCVKc
VYhMV east=XsaTd
kaHWC east=XssFc south=PLfNp
jonRx north=MAxBb south=WILmV west=YztCX
vBfMi east=vPJGB west=CVEhx
MQfzl north=byEuP east=DYRjQ south=ACBUE
FRzLv north=KvsJS east=ojpqd south=AOCak
SBhLp north=zNVcb south=HWLwC west=qPJDc
fMFPD south=pdmqO
uOUNS east=jonRx south=uIpIm
QkApl north=PpTzH south=vPJGB
pBXQh north=jCgMC west=fgHaB
EbJfC north=ZOMxC east=tjcbZ south=zGLuC west=aKwlf
lLmOO east=tUIQt west=yVbTE
yjhjT north=AEYgY east=iXBlX south=AgpTF
Nqoeu east=zGLuC south=pdmqO west=zpFAR
sKFqx south=NMjZy
MtOkh east=rTFpf west=wuqRD
vzwsx north=jWjFv east=uaUsH south=jeBPe
xiRfw north=cOzrJ east=axWOS south=bVvDb west=YztCX
IXzQa north=QHjdi east=glyGC
OmpjC
CqivM north=jTqYE west=UpLhc
UZoss north=ENvWQ west=WILmV
fPtPR
rTFpf north=NnMWG
TmbqI north=jecgj east=JqJcC west=ZXIQP
QDpZB north=KLktu
Uhwlu east=JpiMX south=YztCX west=sdTTZ
flvGg north=WJafw
hSzga north=ZLHSe
OQWmc south=aqrQH west=bVvDb
RLMuV north=sYuzQ east=wPnRX
ckDrj east=NnMWG south=SERtM west=nOHhX
gaHba north=GBcqf south=xethm west=RCQJg
FZCcy north=SJKJE west=VSSfM
JOlKA west=XVqlO
YBHSr east=oYcAL west=QLaON
ajZct east=yVbTE west=sOAOP
Tjwxz west=YINrV
YCjNK north=LDgLR
nUaYd north=BODTr south=IhvIm west=cwNvf
aEGwb east=rqjSq south=VKgWg west=EjgFp
RBBXK east=Gvmyb south=Vhpne west=WxGtq
XVqlO west=jutwz
CgKSt south=nkUKE west=ACBUE
qzdCR south=Tnvhu
TCbcX north=TJSZx east=vUoeK
mnROg north=XssFc west=FgmgH
DRoYn east=SRsyv
JbwCA north=shraL south=fenMG
oaVDw north=KaiuG
UINBh east=xOlPB west=saspP
isDfZ north=XKhWS east=aEJWC south=OQWmc west=qfyFg
KbeYZ north=ILBpn east=EPLwQ west=AgpTF
iVzJq east=tujjS south=ErplB
fDyPx north=iMGOl east=mHUES
ZnJsv east=IfUXv
Kmdwm
BYGzb north=sWAmq west=Zzifl
TAFYk
AgpTF east=GgCNk south=sKFqx
aqrQH west=UyCrF
KuDFh east=uIaPk south=xVmhA west=PjSEz
LAaWn north=HwodK west=ZYinn
grtQf
PyfHI east=oIBnW south=jTqYE west=suYpt
FSjag west=zbzDr
qXRwf north=etoON east=EyfRN west=CfFML
JRXCU east=lsPeA south=HvIep west=KeGNN
KYafM north=jYKsS east=glyGC south=AorRY
zPDfs south=ZYzeD
eVJlD north=MAmfO east=tjcbZ west=xOlPB
ZsEip north=KHDqg west=uoPrX
wXuMV east=jRbZT west=AjWDe
oYcAL north=FfVKR east=OQWmc
uQdFW north=Hrvtr east=bVvDb
bJZPB north=pvFrC
GHkkn north=UdXit east=CMUnr south=QtDfg
Aycye north=uzblh south=ovCkV
pwFEf south=ZwLQT
ekFTn west=rdEYG
uOeax
xmhRj
ACBUE east=iOWbZ south=FGtsa
CTUGC
qflSt south=kHLDf
hnFXm east=LRiTn south=xYdmf
GGGOV north=nBoPr
QHjdi east=bDqzz south=KsnVF
lHjds south=hwEIo west=OYMys
NfARt west=FqxaY
nYriy north=fzOVI south=EqKfh west=ijABn
YWvPg north=oVdOC east=PpTzH
NUbWz south=tBWKS west=EQfni
HUfAA north=XOvwj east=SNKAh south=TAFYk west=ghNJw
TJSZx north=iOWbZ east=zGpwZ south=ekFTn west=tQSns
CMWZr south=ACFwT
CMUnr east=XVqlO
JRllw east=mnROg west=JRllw
zWXVf south=QtDfg
mRwry east=LazqL west=qZwlC
lpncY north=gMoTJ west=CvDsp
Sepxe north=YBhyX south=eZvoh
exIYn north=qPHHW west=BWVca
WmcZc east=bSUwr south=qePLT west=Hrvtr
oKVgr north=qXRwf east=FSRtT west=aghXO
ltjoc north=ShSeq south=xFQEA
eRfbV north=YWvPg east=kYznC
glyGC north=uzblh south=qMFoC west=VYmWn
uCbYU east=ywKwc west=zwRaU
xVmhA east=CTkCN south=sTNnT west=cVGAE
CTkCN south=aEFxF west=YWvPg
yBMAP south=bDiYM west=pYmRF
jWjFv north=fTpma west=vBKfn
vgLwc
ccYIl north=uQdFW south=jutwz
PGSDJ north=rtsbG south=FgmgH
fenMG west=Dojds
tKceH south=XssFc west=ylkNa
HAkaL south=TwpaH
taptb north=xZIPs east=ckDrj south=PaVmY
nMEpH north=uFmOF east=GlzTX south=UvBgU west=jJuEi
fTpma east=gzowr west=etHgb
THFYN north=eXySD west=dBork
uDhCx west=PXLND
qoHxb east=uGFAf south=drfxa
jYKsS
pDKzH east=sKFqx west=aDzFU
IbCbf north=qfyFg
SdIKn north=uQdFW east=CVEhx south=VNTpO west=Iokje
tyMOj north=JTVoC east=LazqL
RCQJg north=dPItI east=dQVoG south=nfrDx west=ajZct
DrSBi south=qWABC
iCSCJ
utfQr south=zpFAR west=OeEWC
PNbnd north=wXuMV south=XOvwj west=iSDeU
KvsJS north=VPGof east=acmfm west=tFRNe
aRxwT north=dPItI east=vBfMi west=ACFwT
oEZDq north=vgLwc
mdZzW north=RprGa east=kOvtF south=OySYU west=MNEkq
TpcHp north=YbjUu east=OUFAQ south=ccYIl west=XVqlO
YzCvV north=AyJxP south=MAmfO
sSyhr east=Saiif south=JqLvE west=attTv
FPcky east=lbRiW
BYxCy east=juJVT west=qfyFg
SJKJE north=xZIPs east=esyag south=MrJNb west=MAxBb
GoTlA south=tUIQt west=tMIrQ
LazqL north=rqjSq south=VTPBL
axWOS north=GNAzl east=hFHGW south=GTWDB
rwFGH north=khQiL east=FGtsa
aghXO south=psYDE
dCftk east=HNWph
JqLvE
GIaKA north=IUasE east=ltTTh west=kVCAa
pGmmy east=uGFAf south=bBtqJ west=XVqlO
ardkR north=ZWIHB east=GBcqf south=aghXO west=SaWrp
qckjq north=xVmhA east=ZxwOo
CYcGG north=pawWf south=VKgWg west=ekFTn
ARnIN north=nwQbD east=gzowr
esyag east=bIbxi south=MTlxS
tFRNe east=mHUES south=TCbcX
zYqAu north=bVzUg east=iOWbZ south=ZwLQT west=isDfZ
FfVKR north=FUksB east=BYDob south=dVksl west=yBQbJ
wHWVd south=sWAmq
BItUm north=CLBNh west=oVTBr
yVEJf north=wskTV east=ATAuy west=hHPqA
cVGAE east=OQxYe south=LRiTn
oUJoY north=JOlKA east=uDhCx south=aghXO
mCjJz south=ufufl west=mdZzW
ACFwT south=xOlPB west=tFRNe
WyUQc north=FJTfm west=oLZRH
udXIC east=SZXji west=OmpjC
tjcbZ north=YRPwU south=Axjxl west=eCHNV
DlrBG north=iVzJq south=JqJcC
pawWf south=SNKAh
oULLN north=hBmwX south=hnFXm
nhNJs north=BYGzb south=sCnpz west=hgBec
HJCJq north=wwyAT east=EHrTW
AWxij north=Tnvhu east=RLMuV
gPZRU south=ZbqAy
hbwlE north=CjUyS south=gMoTJ west=sOAOP
IfUXv north=DupBm west=oIBnW
DfHBs north=PNbnd east=thkJG west=ZqReg
tlPOi west=OXEvK
nSYUy north=GTWDB east=mdZzW south=bDqzz west=YBFrn
lbRiW south=bGCrQ west=gdihg
iOWbZ north=aSNGu south=BRgRG west=eVqiL
cLNaM east=uFmOF west=cBgzN
SlaTM north=RNNhX west=NfARt
CVDim north=iMGOl south=gCzGr
ghNJw north=PLfNp east=fYyid south=HvGje west=DekKT
xwTsv west=UWzDR
Dqzjn north=JRffg west=YBhyX
NhREk
hqVtm north=KJPqS south=WOpfg west=iVzJq
OeEWC east=EFBfY south=Skjdl west=gPZRU
cgSKW north=KgxMT east=xOlPB west=jwfyM
eeVor north=VTPBL east=OUFAQ south=HAkaL
SneLi north=gzowr
kPBqL
LNvdv
yrhVF south=QKxCO west=WBGLL
UEgrd east=YPXkh south=EffSO
WOpfg south=yBMAP
YQhDj north=NVQJT east=ijABn west=PNbnd
EBrzw south=UEoKG west=cGmnK
oVdOC north=YINrV east=TbHHk
EPLwQ east=mCjJz south=MQfzl west=sCnpz
AyJxP north=fYmSs west=jwfyM
CKpHB north=OsOzP south=XVBtO west=cabnx
JsEzO north=ivbUe east=sYQcc
nBdIb north=nhNJs south=LazqL
UZUbi east=qnPls south=KHDqg west=FUksB
wILaq east=ZWIHB west=tujjS
nIvQG east=JsEzO west=yGpxU
NnMWG
sCnpz north=aqrQH west=QUXMj
VJVjE south=jJuEi west=CjUyS
VPGof north=hwEIo east=HyHJE west=Dqzjn
HNWph east=Skjdl south=dnPTU
QHFBT east=iHJcN south=YztCX
dGQfq east=TXhXc
Dojds north=QDpZB south=tKceH west=YXvZC
mHUES
dAXVh north=pGmmy east=EQfni west=sYQcc
TdBGH north=pGmmy east=aKwlf south=YMHXq
zmQdf east=MSTOj
jVkzX north=ekXXC east=zmQdf south=CvbTw west=ofRsj
FgmgH north=CVDim east=TamwN west=nBWdj
xSlbs north=VJLYJ east=pdmqO south=shraL
rPisL east=zGpwZ
nfrDx north=ieuOD south=BVRKy west=oKVgr
JLStI east=FZCcy west=zHedk
ZWIHB north=EUfMH south=EoYUQ
zHedk north=ARnIN west=osKvl
bGCrQ north=attTv west=ltTTh
qZyiG north=ATKIC east=obnlo
qphBF east=DmnLp west=RRdGX
VyPUf south=LASxd
LASxd north=psYDE
WsgJY north=ieuOD
zNVcb east=suYpt
IEBFP north=mnROg south=CVEhx
RdSXN north=PJHxc south=mdZzW
PLfNp north=tneax east=LNvdv west=CVEhx
nwQbD north=JRXCU south=kQLxW west=IfUXv
wPnRX north=SFuOJ east=fYyid south=uIaPk west=wBaLQ
zkYLR east=mPygp west=nYriy
kYznC north=iOWbZ south=XVqlO west=attTv
uaUsH north=VfUnM
GcWIr south=VyGRZ west=jYkoE
CXpes west=qZyiG
KaiuG north=bcjOX east=zWXVf west=UyCrF
NSMBk north=iVzJq east=DMVeh south=QtDfg
czTPF
AorRY north=dBork east=VfUnM west=ghNJw
YPXkh east=HWLwC west=nwQbD
uWOrI north=Zzifl south=cabnx
ZXIQP north=vlInz west=gzowr
fYyid south=gXONv
wskTV north=NnMWG east=ATAuy south=sGnDN west=YBFrn
fKXvt east=flvGg south=PGSDJ west=IfUXv
VMOab north=AgJLW west=cvtCH
eVhvK north=VJLYJ south=OsOzP west=KJPqS
YBhyX north=cOmmx east=ILBpn south=gPZRU
rYpmB north=LXQSy south=NKPLz
FJTfm east=lbRiW
DiPmC north=JqJcC east=tlPOi south=jixOR
WdboJ north=CvbTw east=fzOVI south=rtsbG
MCjNj east=Dqzjn west=CkLLQ
cOzrJ east=iCSCJ
UWzDR north=vPJGB south=oUJoY
SXjZx north=Tnvhu east=xSlbs
ZbqAy north=psYiz south=yjhjT
TwpaH north=qrcPx
SELKv west=Saiif
FgrUU east=vxecf south=fRfVq west=glyGC
tUIQt north=iCSCJ east=amXiN west=qXRwf
FxuDf north=BdFWg east=tUIQt south=yjhjT west=XVBtO
DekKT
jtLSL east=mCjJz
QLaON north=dVksl east=WOpoT
AEYgY east=EFBfY west=HNWph
MAmfO south=iLbGD west=ENvWQ
VTPBL south=rkFeW west=yGpxU
Gvmyb north=ieuOD east=aDzFU south=tZtfU
mPygp east=BItUm south=AWycz west=XborS
dbmxC east=ivbUe south=tjcbZ west=ynvnq
KmsVS north=DWLXk east=iUurS west=MeiAs
UbYgQ east=EPLwQ south=rtsbG west=TmbqI
ltTTh north=RCQJg east=UAcjx south=QkApl west=RCQJg
wbDPL
AgaAX north=oaVDw east=hFHGW west=fDyPx
xwyUf north=edabS west=tikqt
wZjJJ north=ojpqd south=OHFeB west=GgCNk
jRnzL north=XsaTd east=CLBNh west=byEuP
ShSeq north=qzdCR
OUFAQ north=ZpUTd east=KYafM west=jCgMC
dqWzn west=qckjq
qePLT east=CMUnr south=Olptz
ZklOO north=wuqRD south=YBhyX
eoGAH north=nolty south=Nqoeu west=FSRtT
MScSS north=rqjSq west=pYgRs
YIgcI east=SokIg west=RNNhX
wmatt east=nkUKE
Lthuy
LDgLR north=nhNJs east=UyCrF south=xYdmf
STOer south=nnPIr
pdmqO east=eeVor
wBaLQ
lDAwt north=ziVDd south=jonRx
HwodK east=EUlUV
xpgXt north=GHkkn east=EUlUV south=KqbYs west=IIvCc
aNtva east=JTVoC south=TgVpk west=TwpaH
IvQEL north=qnedj west=tyMOj
rdEYG east=qMLjp south=aoCCx west=ZIRQk
qHJaS north=CVDim east=FSjag south=nBoPr west=zXjQf
KeGNN east=UyCrF south=RprGa west=kPBqL
uTOEx
XssFc north=rwePj west=AorRY
DWLXk east=iKYRw south=xmhRj west=JjRqd
kQXSE north=ywKwc east=PhPJm
uIaPk north=YINrV east=sIsVQ
zwESk east=VKgWg south=sTfvu
BRgRG south=SERtM
FaImF north=fDyPx east=EHrTW south=NqIwp west=Dvzzs
ENvWQ north=TwpaH south=jWjFv
kXLxf north=nBWdj west=KYafM
fcFlK north=dVksl west=SrTsN
LRiTn east=YBHSr
jAXpX north=YQhDj south=asrNf
BYDob east=tYCJP south=osKvl
KFHhc north=PGSDJ east=MrJNb south=zwESk west=KaiuG
EFBfY west=IIvCc
mvSuf north=pQWlw west=Olptz
oiAbh north=yTNmP south=TiNUm
sXBpq south=eVhvK
VNTpO north=kOvtF east=jecgj south=rqjSq
dgJFr north=rdEYG
AHivb north=pqUYk east=KoXAN south=qCoPF
BEIBn north=vTihS east=pMBMT
qnHKG south=bJZPB
OrGrF north=IghYw south=fRfVq
amXiN north=MAxBb south=OEeHJ
byEuP east=ILBpn south=QUXMj
ZnkzY north=wPnRX south=SdIKn
azgDI east=FRzLv
jixKO north=ACBUE west=QDpZB
dBork north=JTVoC east=FSRtT west=zmQdf
JjRqd
WILmV north=jRnzL
TxkDE north=SneLi south=AIGpO
XlGLj west=hnFXm
AWycz north=oHMHh south=xdIHq
Luvyu
TRPnU east=ovCkV west=ACBUE
KLktu north=QEeiV east=kXLxf
VJLYJ east=ITavq
oIBnW north=fKXvt east=yYMbN south=DfHBs west=nBdIb
eZoLj east=iLbGD
bcjOX north=wOIgi east=Vhpne south=nMEpH
ErplB south=XVBtO west=oHMHh
xFQEA south=ofRsj
psYDE north=bbsZN east=PXqnK west=YWvPg
FBHpY east=zWXVf
yjjse
bVzUg north=zGLuC south=lpncY west=AmasX
JdrQa
MVzvW north=hBAol east=AWycz
eXySD east=jIuFh south=VNTpO west=FSjag
uBDqC south=FgmgH
bIapb west=qZwlC
ofRsj north=hBmwX
TXhXc north=VyPUf east=FgrUU
olsvl south=SdIKn
PhPJm east=YXvZC
NxeJZ north=oYcAL west=QghNZ
tOLot north=kXLxf east=PhPJm south=LBbdQ
PaEyh south=fYmSs
Zzifl north=ZkBsK south=cVuOR west=izgTT
acmfm north=fcFlK south=FRzLv west=fRfVq
fanfi south=KuDFh west=oUJoY
FUksB north=zwESk east=GSnlR west=oKVgr
aEFxF east=WmcZc west=JRXCU
KUUej east=oVmlD south=LDgLR
taWFH east=CTkCN south=TiNUm west=xpgXt
cOtIx east=rStsJ south=WMqKA
vlInz south=tQAJb
GreuM east=xSlbs
eWEsL north=PhPJm south=VYmWn west=saspP
qKvwI north=zbzDr south=JioUk west=eVhvK
obtJn north=HQbtk east=jAXpX west=adUPr
lZkBi
OYMys north=ZhNCV west=tYCJP
iSDeU north=VSvMu east=isDfZ west=KbivT
jCgMC
IUasE
SokIg east=xmhRj west=QELmi
SdhyI east=ZNxbI
XOvwj south=Jtspl
OEeHJ south=sYQcc
tZtfU east=LXctC south=UdXit west=TxkDE
pvFrC north=KsnVF east=GreuM south=RBBXK
cGmnK north=TwpaH east=RprGa
YRPwU east=TlYDa
saspP north=IJaDD west=qHJaS
nolty north=ekFTn east=iOWbZ
fMXRv west=dgJFr
EUfMH west=CdqUJ
TbHHk north=BRgRG west=nolty
LIOom north=yBGpP east=wHWVd south=EqKfh
qMFoC north=exIYn east=LmQLS
EffSO north=sXBpq east=Gvmyb west=gCzGr
qZwlC east=BnxOF south=DRoYn west=edabS
PJHxc
GTWDB north=oVmlD south=bzIry west=eCHNV
ZwLQT north=SdhyI south=icJPY
pqUYk east=ACFwT
dvsbI north=XlGLj south=gvGdh
KHDqg north=VPGof west=glyGC
IhvIm north=bcjOX east=bBtqJ west=CTkCN
NqIwp west=BWVca
fgHaB east=aqrQH west=zjqBU
aEJWC north=Skjdl east=ltjoc south=Tnvhu
qnedj south=MimIR
hBAol north=uGFAf
uIpIm east=ATKIC south=WILmV west=CveCq
OQxYe south=tibrO west=VNTpO
vPViC south=cOtIx
YMATW north=Axjxl east=hFHGW south=WdboJ west=YBHSr
gaJQx east=qCoPF
sANzR south=DmnLp
hIaOo east=LTyTB south=PjSEz
kKhph north=TdBGH west=DlrBG
gympX west=KUUej
kfwBR south=ZWIHB west=ZwLQT
tQAJb north=VUNnP east=hgoON south=oVdOC west=LXQSy
iASko south=jJuEi
FSSPd east=JjRqd south=DfHBs
ItEmr north=VKgWg
BdFWg north=hFHGW east=kpSdc west=dBork
AmasX east=kfwBR
haJxR north=xpgXt south=CvDsp west=khQiL
WAhpy west=DMBiX
WflNp south=KYafM west=VlJtf
oHMHh south=mryLW
MSTOj north=VJLYJ east=QHjdi west=YQhDj
ZhNCV north=dGQfq east=XLWxi south=kUOwz west=cvtCH
JRffg east=zjqBU south=PCkMu west=EyfRN
CLBNh
sYQcc east=sIsVQ south=ILBpn
TiNUm east=oKVgr south=BedtS
AGjsG north=TCbcX east=yjhjT
YztCX
fzOVI north=lpncY east=HvIep
jixOR north=PCkMu east=OmpjC
NMjZy east=uGFAf
iywCh east=iASko
CfFML south=eVhvK
GNAzl east=ENvWQ south=SZXji
zGpwZ south=VJVjE
iXBlX east=qzdCR
zGLuC east=PjSEz
QUXMj north=bBtqJ
AmMzG north=NMwfW
XborS
BedtS north=fKXvt south=rtsbG
ERrrg south=dgJFr west=DfHBs
CTLAg north=rStsJ east=MtOkh south=hBmwX
rmIJi north=LNvdv south=YCXnF west=pDKzH
opMLo south=CdaRv west=NUtET
DTrzD east=qPHHW
gvGdh north=xethm
WGGVo north=bZBAj
pAihG north=yoHZr south=TwpaH
aJXiL north=saSYk east=sdTTZ south=haJxR west=TdBGH
IsKXy north=vgLwc west=xethm
VUNnP north=BKbQg east=fnpIx west=TCbcX
FqxaY north=pDKzH east=utfQr
cMasc
Olptz east=xpgXt south=jTqYE
bRnRC north=HWlaZ south=CvbTw west=PKFTj
lWkMf south=dvsbI
IJaDD north=xFQEA east=AmMzG south=KbivT west=EbJfC
HWlaZ north=rmIJi south=UpLhc
OXEvK north=EUlUV east=LAaWn west=yhwwW
EZSSR east=LIOom west=yjjse
VSSfM east=cMasc west=dxtIm
DYRjQ north=mRECC east=fYyid south=UdhPZ
EqKfh north=kfwBR
SaWrp north=EjgFp east=Sepxe south=QkApl
UOvJd west=GBcqf
LoSPT east=kYznC south=fYmSs
Jtspl south=wHWVd west=NUbWz
yYMbN north=OEeHJ east=tibrO west=OuWhO
eZvoh east=EffSO
YfNRP north=dGQfq south=NUtET west=haJxR
VKgWg north=ARnIN south=mHUES
tQSns south=MBqBP west=TAFYk
AIGpO east=epdhg south=gzTol west=iASko
MrJNb north=HvGje
AZMDW north=LAaWn east=tZtfU west=CVEhx
uqbJe north=DRwOi east=kOvtF
kQLxW west=qnHKG
TRKzD east=TRKzD west=VPgCT
ojpqd south=NUtET
uGFAf
PCkMu south=YBHSr west=jixOR
bBtqJ east=AyJxP west=kHLDf
DupBm north=DRwOi east=eiymz
tBWKS south=ygfTn
dnPTU east=EkklO south=Gvmyb
TlYDa east=uzblh west=UMcBn
RByhz north=cGmnK west=NuZar
cHays north=aghXO east=BEIBn
qPJDc east=CfFML south=JyRAa west=XsaTd
iHJcN north=UdhPZ south=ARnIN west=aqrQH
ZzNKx north=Vhpne east=UEoKG
qrcPx north=FbjUl west=SXjZx
vhaCK east=QfFzp south=SrTsN west=dVksl
oaQRb north=ZqReg east=CYcGG south=WyGum west=sIsVQ
ADijx north=mqZvD
YbzCP north=AWycz
suYpt south=hwEIo west=uBDqC
ZOMxC north=WyGum south=DDjqo west=WILmV
ZvPvl
OuWhO east=Hrvtr south=yBGpP west=sTNnT
VSvMu east=YXvZC west=oVdOC
BWVca west=LTyTB
ZeNUO north=Dqzjn west=WyUQc
lrhla east=ZYzeD west=MVyTH
rhLDk north=RxfyI east=NYoJP south=kQXSE
bzIry east=NSMBk south=Gvmyb west=MTlxS
MefKR west=HmTej
TgVpk east=vxecf south=yBQbJ
BVRKy north=jwfyM east=ylkNa south=CgKSt
nvLfT north=ZklOO east=zRgDJ west=VJVjE
qPHHW south=xVmhA west=QKxCO
sYuzQ east=uDhCx south=GBcqf west=aEJWC
MNEkq
ieuOD east=mHUES
LBbdQ east=MSTOj west=fIFlk
csAUi east=yjhjT south=NvUsA
PaVmY north=pMkZN south=qBLzt west=wfVGd
mHhxJ south=uaUsH west=uSivh
vTihS south=OYMys west=SaWrp
yTNmP north=aEJWC east=oEZDq south=vgLwc west=hFHGW
hansI
CdaRv north=lpncY east=OQWmc south=IvQEL
KHiUx east=gCzGr south=ZXIQP
EQfni east=qphBF south=rhmpm
iNVVV east=pvFrC south=ekXXC west=bIbxi
yVbTE east=ovCkV south=YzLdg west=CYcGG
rHzKl north=yTNmP east=SXjZx
ugYxy south=ZIRQk west=tQAJb
ZVhZN north=KbeYZ
cBgzN north=ShSeq east=YzLdg
edabS north=aEJWC east=wXuMV south=QKxCO
WyGum north=vlInz west=XoYzO
UpLhc north=LBbdQ east=OEeHJ south=eiymz
etoON north=PpTzH east=OeEWC south=BRgRG west=WyGum
uSivh north=sdTTZ east=SRsyv south=pdmqO west=KHDqg
JTVoC north=PjSEz east=qphBF west=YfNRP
nnsEe north=ABvAa east=yBQbJ south=edabS west=DBlUE
osKvl south=Olptz west=oYcAL
NKPLz north=mRwry east=VKaun
ejLAX north=HWlaZ east=ZcTwO west=Vhpne
FmNKW north=DrSBi east=WaJUC
mryLW south=oaQRb west=yoHZr
CVEhx north=xfLSz south=GIaKA west=gdihg
PKFTj east=VPgCT south=cGmnK west=eRfbV
YMHXq south=tobuu
PpTzH north=dqWzn west=CVEhx
zbzDr north=sGnDN east=VSvMu south=tZtfU west=fovtm
tikqt east=GreuM south=SZXji west=ErplB
VPgCT
etHgb north=xmhRj east=VQedl west=xwyUf
QtDfg north=jRnzL east=rwFGH
AOCak north=OYMys east=NBZkb south=qfyFg west=gzowr
RheHC east=haJxR west=KJPqS
dgSBx east=MQfzl
vUoeK north=rhLDk west=etoON
tneax
gCzGr east=hansI
hwEIo north=hBAol east=PGSDJ south=SdIKn west=WpZkq
UvBgU north=OUFAQ east=ACFwT
lMKFq north=ivbUe south=acmfm west=KLktu
ZkBsK north=ZOMxC
yewmZ north=ItEmr east=EqKfh south=lDAwt
nvNWj south=VJVjE west=BUYYw
rtsbG east=LmQLS
vPJGB north=MVzvW south=oVdOC
sWAmq north=QtDfg west=vPJGB
UdXit east=HWLwC south=Lthuy west=CMWZr
IrOrK west=OYMys
SFuOJ north=JioUk
LmQLS south=ojpqd west=VVxid
khQiL north=TiNUm south=CKpHB west=ShSeq
Tnvhu north=flvGg east=fIFlk west=zYqAu
WOpoT north=VSSfM east=hansI south=aJXiL west=cEdio
KgxMT south=aqrQH west=dCftk
fRfVq south=YcGVk west=dvsbI
juJVT east=OsOzP
tujjS west=MrJNb
xZIPs north=DDjqo east=wwyAT south=eiymz west=AGjsG
lsPeA north=rPisL east=cKcCY
ywKwc east=CvvWE west=INoGW
xfLSz east=XMUpZ south=HKxdS
UdhPZ north=ynvnq west=AmasX
GLEXp north=EkklO east=KLktu south=attTv
SrTsN
OHFeB south=HJCJq west=nolty
sTNnT north=wskTV south=OySYU
SZXji north=YCjNK east=EQdQZ
ACoxn east=NOrXp west=qWABC
DBlUE north=xdIHq east=JjRqd
MimIR east=LIOom west=DrSBi
LXctC south=RNNhX west=grtQf
kVCAa
iCEEC north=ZOMxC east=YPXkh
EdBMr west=ZnJsv
CQmyV east=UINBh south=dgSBx west=Olptz
BnxOF north=HJCJq east=oVmlD
EHrTW north=CKpHB east=KbivT west=DBlUE
nOHhX north=gSZiu east=uaUsH south=CkLLQ west=TmbqI
EQdQZ north=oaVDw south=ZvPvl west=nmQcl
gdgZg north=MAmfO east=ghNJw west=jRbZT
jecgj north=ovCkV east=ghNJw south=oVTBr
aJJVV north=EjgFp south=LXctC west=cGmnK
XLWxi east=NqVUf south=tFRNe
ZNxbI north=yrhVF south=LIOom
iUurS north=gdihg west=hBVFa
PXLND east=eCHNV south=LAaWn
vxecf north=FqxaY west=HJCJq
jIuFh north=aSNGu east=TmbqI west=YMHXq
aDzFU east=qePLT south=GoTlA west=ENvWQ
oxaKX north=AgaAX east=vhaCK south=ZWIHB west=kKhph
IdFOl north=zHedk
eVqiL north=OQxYe west=fDyPx
QghNZ west=XWumO
SERtM south=psYiz west=KqbYs
mRECC east=QHFBT south=zwRaU
tukbn east=eVqiL
iKYRw north=crOqY east=vlInz west=byEuP
pMBMT east=WOpfg south=PXLND west=gPZRU
HvGje
ILBpn north=aEFxF east=ACoxn west=JRffg
VyGRZ south=fzOVI west=OQWmc
GypAo east=YPXkh south=YRPwU west=mqZvD
dLOOA north=eXySD east=taWFH
xOlPB
KAddR north=CjUyS east=UbYgQ west=nnsEe
cKcCY east=eZoLj
BUYYw south=bbsZN west=GLEXp
iMGOl north=TRPnU east=vBfMi west=ErplB
hgoON north=tFRNe south=cOtIx
ufufl east=DfHBs west=jonRx
WugrH south=qePLT
QELmi north=NSMBk east=JioUk south=fanfi west=qMLjp
qMLjp north=dVksl south=pQWlw
oVmlD north=QyAIB west=BnxOF
wolBc
cwNvf north=UdhPZ east=HJCJq
MGbAm north=ZnJsv east=fMXRv west=UMcBn
ygfTn west=lDAwt
ITavq north=wXuMV west=rdEYG
EOWNb
VfUnM north=GcWIr
MBqBP north=VyGRZ south=jeBPe west=lWkMf
GIQHe north=kfwBR
FSRtT north=Saiif east=eXySD south=QLaON
IIvCc north=VSSfM east=sOAOP
qBLzt north=oiAbh south=sWAmq west=DMVeh
ZYzeD west=jAXpX
aKwlf east=mRECC south=lLmOO
NYoJP north=AgaAX south=oaQRb
lXwZu north=MSTOj south=tQSns west=aDzFU
xdIHq east=KeGNN
tibrO east=dgSBx
lCwcZ north=VJLYJ east=dqWzn south=PJHxc
ZcTwO north=ROKEU east=DTrzD west=udXIC
QDNfs north=Bisbn south=qoHxb
sTfvu north=bIbxi east=GypAo west=nYriy
eEEti east=CLBNh south=bcjOX west=IXzQa
NBwmg
Dfzdh south=nSYUy
QfFzp
wOIgi north=Lthuy south=fMFPD west=oVdOC
hBmwX north=LASxd south=TpcHp
GBWUE south=zNVcb west=wZjJJ
NBZkb south=FBHpY west=PmiBo
JioUk west=GgCNk
zXjQf north=aDzFU south=VfUnM west=dvsbI
QyAIB south=zonQh west=PjSEz
ivbUe
vnIvc north=osKvl west=nvLfT
VVxid
oVTBr north=dLOOA east=MimIR west=NUbWz
GSnlR north=sTfvu east=Lthuy south=kOvtF
jutwz north=ZYinn east=UZoss south=aNtva west=bDqzz
iuVQr north=yBQbJ east=JbwCA west=esibi
LSrES north=ZnkzY east=ZsEip south=hwEIo west=nvLfT
KoXAN
tMIrQ north=udXIC south=Aycye west=Dojds
PmiBo south=WBGLL west=kPBqL
thkJG north=yYMbN east=JzFLN south=FfVKR
oULZN north=VSvMu east=vzwsx south=BYDob west=zkYLR
jYkoE north=sWAmq east=BKbQg south=PEIVR
EoYUQ north=yVbTE east=ltTTh south=thkJG west=BRgRG
BaKOf north=ZYinn west=lbRiW
BOasT east=iASko west=fPtPR
qQDpo east=HKxdS west=LAaWn
hXcGP north=DRwOi east=oEZDq
sOAOP north=KsnVF south=ZXIQP
YbjUu north=qQDpo east=XpXEP
uFmOF east=uCbYU west=OrGrF
DOVHQ north=YQhDj east=GBWUE south=NvUsA
BfQAY east=JioUk south=EBrzw west=cEdio
psYiz north=NqVUf east=HmTej west=WBGLL
PEIVR north=tFRNe
KsnVF north=kQLxW west=gympX
kHLDf north=lDAwt
jJuEi south=FZCcy west=ZvPvl
NuZar north=JLStI east=rTFpf west=dxtIm
MAxBb north=QnmDK east=YBHSr west=sIsVQ
aOqkq south=WOpoT west=YztCX
NVQJT north=RNNhX east=IrOrK south=poKzN
saSYk west=Aycye
WJafw north=tvZub east=sGnDN south=rTFpf west=rrSyj
oLZRH north=vTihS
ekXXC east=nsBrN south=dgSBx
uoPrX east=CTUGC south=kKhph
CveCq north=lCwcZ west=pjWff
HvIep south=BEIBn
JyRAa south=CvDsp west=aPmTh
FhRsS north=pMBMT west=oIBnW
MVyTH north=CTUGC east=aqrQH south=ieuOD west=LIOom
aBgPt east=wskTV west=JzFLN
nkUKE south=wBaLQ west=suYpt
rrSyj
CdqUJ north=sWAmq east=zqWCj south=KmsVS
jETcS east=WdboJ west=TJSZx
XyLXN north=fzOVI west=iXBlX
LTyTB north=ZsEip east=uCbYU south=ZXIQP
KbivT north=GBWUE west=JsEzO
uJRZP north=PNbnd south=IUasE
wuqRD east=UEoKG
aPmTh north=LXQSy east=tneax west=FfVKR
cOmmx south=JRXCU west=XVqlO
hFHGW north=Hrvtr east=UdXit
gSZiu north=qoHxb west=pDKzH
UTcEs north=Sepxe south=YbzCP west=ugYxy
UMcBn east=jVkzX
gdihg north=PjSEz
hBVFa east=uWOrI west=opMLo
XVBtO north=JRXCU
ynvnq south=hFHGW west=csAUi
CvDsp south=pMkZN west=lDAwt
tobuu south=LXctC west=gvGdh
XMUpZ north=tFRNe east=PmiBo west=jixOR
tvZub north=DekKT east=NMwfW south=EdBMr west=ljYiC
yBGpP
fbQwv south=YQhDj
Axjxl north=TCbcX west=ovCkV
obnlo north=uOeax west=vzwsx
ROKEU north=wPnRX
pjWff south=KJPqS
NKydR east=AEYgY
scmYI north=iCSCJ
CvbTw east=hwEIo south=uOeax
oFkRD south=VlJtf
KJPqS north=tZtfU east=KvsJS
icJPY east=ltjoc west=ZVhZN
bZBAj south=WyUQc
NUtET north=OeEWC south=PmiBo west=CXpes
OsOzP north=zYqAu east=PCkMu west=NfARt
crOqY north=bIbxi south=UINBh
jrfTO east=ZsEip west=wHWVd
GmQIj north=udXIC
PjSEz east=WOpoT west=pYmRF
esibi east=lMKFq south=fanfi west=JqLvE
ZYinn east=NVQJT south=lrhla
eCHNV north=cGmnK south=GNAzl
eiymz north=olsvl south=mcSNj west=MtOkh
XWumO north=VTPBL west=CVDim
xLDcW east=QELmi south=QDpZB west=GlzTX
IghYw east=UTcEs west=SRsyv
bSUwr east=qrcPx
YINrV north=CVDim south=Bisbn
fnpIx west=wJzRx
VKaun south=bGCrQ
fYmSs north=zYqAu east=UWzDR
bIbxi east=vPViC
ZpUTd east=iHJcN
sSjAD north=OuWhO east=aNtva south=NOrXp west=CLBNh
WaJUC east=dxtIm south=XMUpZ west=amXiN
fhFVN north=TmbqI east=ADijx west=lWkMf
WpZkq west=yTNmP
ZPYOK east=xZIPs south=dvsbI west=FksPi
QnmDK north=fPtPR east=AmMzG south=DMVeh west=osKvl
KqbYs west=FPcky
VQedl south=RByhz
ljYiC east=axWOS south=ZqReg
shraL east=uOeax south=flvGg west=gPZRU
cabnx north=qnedj east=pGmmy west=yVEJf
sqhwR east=EbJfC south=jETcS west=SJKJE
QKxCO east=XborS south=sWAmq west=rrSyj
fIFlk west=CveCq
jwfyM
EphbK north=XVBtO south=psYDE west=aqrQH
zqWCj east=VyPUf south=zXjQf
RRdGX north=FxuDf
qWABC north=wJzRx east=ZnkzY
yhwwW north=YPXkh east=aPmTh south=eXySD
LXQSy north=WxGtq east=zkYLR
HWLwC east=ILBpn west=rYpmB
dVksl east=hBAol west=tZtfU
OySYU north=OmpjC south=OuWhO
UAcjx east=fPrzK
rCVKc east=qHJaS
xYdmf north=iUurS
UEoKG north=rkFeW east=rdEYG south=bIapb west=UTcEs
ovCkV east=nYriy south=IUasE
QQstt east=wfVGd west=uqbJe
Bisbn south=GlNWq
CjUyS south=UINBh
rhmpm north=bbsZN east=TlYDa west=HvIep
VYmWn south=KFHhc
dQVoG
HKxdS north=ZWIHB south=rhmpm west=EdBMr
kpSdc north=jETcS south=IEBFP
Dvzzs north=HdsGh east=VVxid south=HUfAA
yoHZr north=AOCak south=iKYRw
gzTol north=GlNWq
attTv east=qzdCR south=XoYzO west=ijABn
zRgDJ south=oxaKX west=XMUpZ
EkklO north=WdboJ east=haJxR
XsaTd north=KHDqg
HFDcp north=UWzDR south=jonRx west=exIYn
xMerJ east=TiNUm south=QELmi west=QQstt
nBoPr south=qZwlC
dPItI east=uFmOF south=fhFVN west=qphBF
QEeiV
rwePj east=EffSO south=uSivh west=oULLN
TRMql west=yYMbN
DMBiX north=rStsJ east=MSTOj west=cvtCH
NvUsA north=kQXSE east=wbDPL
NqVUf south=eZoLj west=eRfbV
fovtm south=azgDI
iLbGD north=bBtqJ east=zYqAu
rStsJ east=gaHba
xethm north=IdFOl east=YCXnF south=AgpTF
zonQh east=Hrvtr
qnPls
qTsfB east=pwFEf south=eZoLj west=BOasT
HQbtk east=acmfm south=LRiTn
FGtsa east=RprGa
qCoPF north=GlzTX west=QQstt
NHnfI north=DupBm east=tjcbZ west=PKFTj
sGnDN
Saiif south=ardkR west=RCQJg
WMqKA north=ZhNCV east=CFFOD west=SFuOJ
cVuOR south=DMBiX
JqJcC
Hrvtr north=ccYIl west=ZXIQP
sdTTZ south=aJXiL
bbsZN north=juJVT east=ZYinn
ATAuy north=cGmnK south=PEIVR
nBWdj north=cBgzN east=YPXkh west=PJHxc
JaAYL south=BYxCy
ATKIC north=juJVT west=TRKzD
RprGa north=pAihG east=CQmyV
asrNf north=CLBNh east=GTWDB
HdsGh north=TdBGH east=aEFxF
YzLdg north=zwESk east=ZNxbI west=uGFAf
kUOwz south=cVuOR west=khQiL
